type octile
height 5
width 11
map
TTTTTTTTTTT
T.T...T...T
T.T.T.T.T.T
T...T...T.T
TTTTTTTTTTT
