type octile
height 5
width 29
map
TTTTTTTTTTTTTTTTTTTTTTTTTTTTT
T............TTT............T
T...........................T
T............TTT............T
TTTTTTTTTTTTTTTTTTTTTTTTTTTTT
