type octile
height 4
width 29
map
TTTTTTTTTTTTTTTTTTTTTTTTTTTTT
T...........................T
T............TTT............T
TTTTTTTTTTTTTTTTTTTTTTTTTTTTT
