type octile
height 5
width 29
map
TTTTTTTTTTTTTTTTTTTTTTTTTTTTT
T...........................T
T...........................T
T...........................T
TTTTTTTTTTTTTTTTTTTTTTTTTTTTT
